999999999999
911111111119
915000000019
910000000019
910000000019
910000200019
910000000019
910000000019
910000000019
910000000319
911111111119
999999999999
