9999999999
9991111199
9111000199
9135200199
9111023199
9131120199
9101030119
9120422319
9100030019
9111111119
9999999999
