999999999
911111119
915000019
910002019
910020319
910202319
910033019
911111119
999999999
