0000000000
0000000000
0000000000
0000000000
0000000000
0111111110
0150000010
0100020310
0111111110
0000000000
