9999999999
9111111119
9100000019
9100000019
9100500019
9100020019
9100001119
9100001319
9111111119
9999999999
