9999999999
9111111119
9150000019
9100020019
9100202319
9102020319
9100202319
9100333319
9111111119
9999999999
