999911111999
999110001119
991100000019
911021221011
110200200201
100101210101
100333533331
100111111111
111199999999
