9999999999
9999999999
9999999999
9999999999
9999999999
9999999999
9111111119
9150020319
9111111119
9999999999
