9999999999999
9999111111999
9999103331999
9111133331999
9100111201119
9102020022019
9150202000019
9100011100019
9111119111119
9999999999999
