9999999999999999999
9999999999999999999
9999999999999999999
9999999999999999999
9999111119999999999
9999100019999999999
9999120019999999999
9911100211999999999
9910020201999999999
1110101101999111111
1000101101111100331
1020020000000000331
1111101110151100331
9999100000111111111
9999111111199999999
9999999999999999999
