0000000000
0000000000
0000000000
0000000000
0000000000
0000000000
0111111110
0150020310
0111111110
0000000000
