9999999999
9999999999
9999999999
9999999999
9999999999
9111111119
9150000019
9100020319
9111111119
9999999999
