1111999999
1031999999
1001119999
1400019999
1002519999
1001119999
1111999999
9999999999
9999999999
9999999999
