999999999999999999
911111111111111119
910000000000000019
910000000000000019
910000300001000019
910000000001000019
910000000001000019
910200000001000019
910000000001000019
910111111111000019
910000000000000019
910000000000000019
911110000000000019
910000000000000019
910000000000000019
915000000000000019
911111111111111119
999999999999999999
