1111111111111111
1000000000000001
1000000000000001
1000000000000001
1000001000000001
1000000000000001
1000001000000001
1000000000000001
1000011111110001
1000002031000001
1000502311000001
1000000000000001
1000000000000001
1000000000000001
1000000000000001
1111111111111111