999999999999999999
911111111111111119
910000000000000019
910000000000000019
910000000000000019
910000000000000019
910000000000000019
910020000000000019
910000000000000019
910000000000040019
910300000000050019
910111000000000019
910001000000000019
910001000000000019
910000000000000019
910000000000000019
911111111111111119
999999999999999999
