11111111111111
10000000000001
10000000000001
10000000000001
10001111100001
10005000100001
10000010230001
10000210100001
10000312000001
10000013000001
10000010000001
10000010000001
10000010000001
11111111111111