9999999999999999
9111111111111119
9100000000000019
9100000000000019
9100000002000019
9100000000000019
9100000000000019
9100000000000019
9100000400300019
9100000000000019
9100000000000019
9100050000000019
9100000000000019
9100000000000019
9111111111111119
9999999999999999