9999999999999999
9111111111111119
9100000000000019
9100000000000019
9100000200000019
9100000000000019
9100003005000019
9100000000000019
9100000300000019
9100002000000019
9100000000000019
9100000000000019
9100000000000019
9100000000000019
9111111111111119
9999999999999999