11111111111111
10000000000001
15000000000001
11110111100001
10000000000001
10001100000001
10000001100001
10000000230001
10000000000001
10000000000001
10000000000001
10000000000001
10000000000001
11111111111111