999999999999999999
911111111111111119
910000000000000019
910000000000000019
910000000000000019
910000000000000019
910002001000000019
910011111000000019
910000000000000019
910000000000040019
910000000000050019
910311000000000019
910101000000000019
910001000000000019
910000000000000019
910000000000000019
911111111111111119
999999999999999999
