9999999999999999
9111111111111119
9100000000000019
9100000000000019
9100000000000019
9100000000000019
9100000030000019
9100050020000019
9100002000000019
9100000023000019
9100003000000019
9100000000000019
9100000000000019
9100000000000019
9111111111111119
9999999999999999