1111111111111111
1000000000000001
1000000000000001
1000000000000001
1000111110000001
1000500010000001
1000001023000001
1000021010000001
1000031200000001
1000001300000001
1000001000000001
1000001000000001
1000001000000001
1000001000000001
1000001000000001
1111111111111111