9999999999999999
9111111111111119
9100000000000019
9100000001000019
9100000001000019
9100000001005019
9100003201000019
9100000001000019
9100000001000019
9100000000000019
9100000000000019
9100000000200019
9100000000003019
9100000000000019
9111111111111119
9999999999999999