9999999999999999
9111111111111119
9100000000000019
9100000000000019
9100000000000019
9100000111111019
9100000000001019
9100050023001019
9100000101001019
9100000102031019
9100000100000019
9100000100000019
9100000000000019
9100000000000019
9111111111111119
9999999999999999