9999999999999999
9111111111111119
9100000000000019
9100000000001019
9100000000001019
9100000000001019
9101111110101019
9100000010101019
9111111010121019
9100000010131019
9101111110111019
9100000010000019
9100050010000019
9100011110000019
9111111111111119
9999999999999999