1111111111111111
1000000000000001
1000000000000001
1001000000000001
1001110001000001
1001310100000001
1002002301000001
1000010001000001
1000111111100001
1000000010000001
1000000110000001
1000032000000001
1000111111050001
1000000000000001
1000000000000001
1111111111111111