1111111111111111
1000000000000001
1500000000000001
1111011110000001
1000000000000001
1000110000000001
1000000110000001
1000000023000001
1000000000000001
1000000000000001
1000000000000001
1000000000000001
1000000000000001
1000000000000001
1000000000000001
1111111111111111