1111111111111111
1000000500000001
1000000500000001
1000000020002301
1000001030100001
1000000010000001
1000001000100001
1000000000000001
1000011111110001
1000000031000001
1000000011000001
1000000000000001
1000011111100001
1000000000000001
1000000000000001
1111111111111111