9999999999999999
9111111111111119
9100000000000019
9100000000000019
9100111000000019
9100131000100019
9100101010000019
9100202300100019
9100001000100019
9100011111110019
9100000001000019
9100000011000019
9100003200000019
9100011111105019
9111111111111119
9999999999999999