1111111111111111
1000000000000001
1000000000000001
1001011110000001
1001010000000001
1001013110000001
1001002001000001
1001000001000001
1001011110000001
1000000010000001
1000000110000001
1000032000050001
1020111111000001
1030000000000001
1000000000000001
1111111111111111