1111111111111111
1000000000000001
1000000000000001
1000000000000001
1000010230000001
1000050000000001
1000010230000001
1000000000000001
1000111111100001
1000000010000001
1000000110000001
1000000000000001
1000000000000001
1000000000000001
1000000000000001
1111111111111111