999999999999999999
911111111111111119
910000000000000019
910000000000000019
910000000000000019
910000000000000019
910000000000000019
910000000000000019
910000000000000019
910000032500000019
910000000000000019
910000032000000019
910000320000000019
910000000000000019
910000000000000019
910000000000000019
911111111111111119
999999999999999999
