1111111111111111
1000000000000001
1000000000000001
1000103200000001
1000111000100001
1000131010000001
1000200000100001
1000001000100001
1000011111110001
1000000001000001
1000000011000001
1000003250000001
1000011111100001
1000000000000001
1000000000000001
1111111111111111