9999999999999999
9111111111111119
9100000000000019
9100000000000019
9100100000000019
9100111000100019
9100101010000019
9100051000100019
9100001000000019
9100011111110019
9100020031000019
9100000011000019
9100000000000019
9100011111100019
9111111111111119
9999999999999999