11111111111111
10000000000001
10000000000001
10000000000001
10000000000001
10000000011101
10000000010001
10000000012001
10000000003001
10000011111101
10000015000001
10000000000001
10000000000001
11111111111111