999999999999999999
911111111111111119
910000000000000019
910000000000000019
910000000000000019
910005000000000019
910000000000000019
910000000000000019
910000000000000019
910000000000000019
910000010000000019
910000010000000019
910000012000000019
910000010000300019
910000010002000019
910000030000000019
911111111111111119
999999999999999999
