11111111111111
10000000000001
10000000000001
10000000000001
10500000000001
10011000000001
10000000000001
10022000000001
10033000000001
10000000000001
10000000000001
10000000000001
10000000000001
11111111111111