1111111111111111
1000000000000001
1000000000000001
1000100000000001
1000111000100001
1000131010000001
1005200230100001
1000001000000001
1000011111110001
1000000001000001
1000000011000001
1000000000000001
1000011111100001
1000000000000001
1000000000000001
1111111111111111
