11111111111111
10000000000001
10000000000001
10010320000001
10011100010001
10013101000001
10020000010001
10000100010001
10001111111001
10000000100001
10000001100001
10000320500001
10000000000001
11111111111111