9999999999999999
9111111111111119
9100000000000019
9100101101000019
9100101320000019
9100101301000019
9100100200100019
9100100000100019
9100101111000019
9100502030000019
9100000000000019
9100100000010019
9100011111100019
9100000000000019
9111111111111119
9999999999999999