9999999999999999
9111111111111119
9100000000000019
9100000001000019
9100000001000019
9101100111000019
9100000001000019
9111001101000019
9100500001000019
9101111111000019
9100000001000019
9100020001000019
9100000001000019
9100000000030019
9111111111111119
9999999999999999