999999999999999999
911111111111111119
910000000000000019
910000000000000019
910000000200000019
910000000000000019
910000000000000019
910000000000000019
910000040030000019
910000000000000019
910000000000000019
910005000000000019
910000000000000019
910000000000000019
910000000000000019
910000000000000019
911111111111111119
999999999999999999
