1111111111111111
1000000000000001
1000000000000001
1000001023000001
1000000500000001
1000001023000001
1000000000000001
1000011111110001
1000000001000001
1000000011000001
1000000000000001
1000000000000001
1000000000000001
1000000000000001
1000000000000001
1111111111111111