999999999999999999
911111111111111119
910000000000000019
910000000000000019
910000000100000019
910000000100000019
910000000100000019
910110011100000019
910000000100000019
911100110100000019
910000000100000019
910111111100000019
910000000100000019
910000000100000019
910000000100000019
910000005023000019
911111111111111119
999999999999999999
