1111111111111111
1000000000000001
1000000000000001
1000000000000001
1000000020230001
1000000030000001
1000001110000001
1000100510000001
1000000010000001
1000100010000001
1000000000000001
1000000000000001
1000000000000001
1000000000000001
1000000000000001
1111111111111111