9999999999999999
9111111111111119
9100000000000019
9100050000000019
9100000000000019
9100000000000019
9100000000000019
9100000000000019
9100000100000019
9100000100000019
9100000120000019
9100000100003019
9100000100020019
9100000300000019
9111111111111119
9999999999999999