1111111111111111
1000000000000001
1000000000000001
1000101111000001
1000101000000001
1000101311000001
1000100200100001
1000100000100001
1000101111000001
1000000001000001
1000000011000001
1000003200050001
1002011111100001
1003000000000001
1003000000000001
1111111111111111