999999999999999999
911111111111111119
910000000000000019
910000000000000019
910000000000000019
910000000000000019
910004000000000019
910045000000000019
910004000000000019
910000000000000019
910000000000000019
910000000000000019
910000000000000019
910000000000030019
910000020000000019
910000000000000019
911111111111111119
999999999999999999
