9999999999999999
9111111111111119
9100000000000019
9100000000000019
9100000000000019
9100000000000019
9100000000000019
9100200000000019
9100000000000019
9100000000000419
9103000000000519
9101110000000019
9100010000000019
9100010000000019
9111111111111119
9999999999999999