999999999999999999
911111111111111119
910000000000000019
910000000000000019
910000000000000019
910000000000000019
910000000000000019
910000000000000019
910000000000000019
910000400000000019
910320500000000019
910111000000000019
910001000000000019
910001000000000019
910000000000000019
910000000000000019
911111111111111119
999999999999999999
