9999999999999999
9111111111111119
9100000000000019
9100000000000019
9100000000000019
9100000000000019
9100000000000019
9100000004000019
9100000045000019
9100000004200019
9100000000300019
9100000000000019
9100000000000019
9100000000000019
9111111111111119
9999999999999999