1111111111111111
1000000000000001
1000000000000001
1000000000000001
1000000000000001
1000000000000001
1005110000000001
1000000000000001
1000220000000001
1000330000000001
1000000000000001
1000000000000001
1000000000000001
1000000000000001
1000000000000001
1000000000000001
1111111111111111