9999999999999999
9111111111111119
9100000000000019
9100000000000019
9100000000000019
9100020010000019
9100111110000019
9100000000000019
9100000000000419
9100000000000519
9103110000000019
9101010000000019
9100010000000019
9100000000000019
9111111111111119
9999999999999999
