999999999999999999
911111111111111119
910000000000000019
910000000000000019
910000000000000019
910000000000000019
910000000000000019
910000000000000019
910000050000000019
910000000000000019
910000000000200019
910000000000300019
910000000000000019
910000000000000019
910000000000000019
910000000000000019
911111111111111119
999999999999999999
