1111111111111111
1000000000000001
1000000000000001
1000000000000001
1000000000000001
1000000000000001
1000000010000001
1000000010000001
1000000023000001
1000011111110001
1000000010000001
1000000005000001
1000000000000001
1000000000000001
1000000000000001
1111111111111111