9999999999999999
9111111111111119
9100000000000019
9100000000000019
9100000000000019
9100040000000019
9100450000000019
9100040000000019
9100000000000019
9100000000000019
9100000000000019
9100000000000019
9100020000000319
9100000000000019
9111111111111119
9999999999999999
