11111111111111
10000000000001
10000000000001
10000000000001
10000000000001
10005000002301
10000012100001
10000213100001
10000300000001
10000000000001
10000000000001
10000000000001
10000000000001
11111111111111