1111111111111111
1000000000000001
1001011010000001
1001013200000001
1001013010000001
1001002001000001
1001000001000001
1001011110000001
1005020300000001
1000000000000001
1001000000100001
1000111111000001
1000000000000001
1000000000000001
1000000000000001
1111111111111111