1111111111111111
1000000000000001
1000000000000001
1000000000000001
1000010001000001
1000000100000001
1000010001000001
1000000000000001
1000111111100001
1000000310000001
1000020110000001
1005000000000001
1000111111000001
1000000000000001
1000000000000001
1111111111111111