1111111111111111
1000000000000001
1000000000000001
1000100000000001
1000111000100001
1050101010000001
1000200030100001
1000001000000001
1000011111110001
1000000031000001
1000000011000001
1000000000000001
1000011111100001
1000000000000001
1000000000000001
1111111111111111