1111111111111111
1000000000000001
1000000000000001
1000000000000001
1050000000000001
1001100000000001
1000000000000001
1002200000000001
1003300000000001
1000000000000001
1000000000000001
1000000000000001
1000000000000001
1000000000000001
1000000000000001
1111111111111111