999999999999999999
911111111111111119
910000000000000019
910000000000000019
910010000000000019
910011100010000019
910010101000000019
910005100010000019
910000100000000019
910001111111000019
910002003100000019
910000001100000019
910000000000000019
910001111110000019
910000000000000019
910000000000000019
911111111111111119
999999999999999999
