9999999999999999
9111111111111119
9100000000000019
9100101111000019
9100101000000019
9100101311000019
9100100200100019
9100100000100019
9100101111000019
9100002030000019
9100000000000019
9100103200010019
9100011111100019
9100500000000019
9111111111111119
9999999999999999