9999999999999999
9111111111111119
9100000000000019
9100000000000019
9100000000000019
9100050000000019
9100000000111119
9100000000100019
9100000000000019
9100011110000019
9100010030002019
9100011110000019
9100000010000019
9100000010000019
9111111111111119
9999999999999999
