9999999999999999
9111111111111119
9100000000000019
9100000000000019
9100000000000019
9100000000000019
9100000000000019
9100000320000019
9100000010000019
9100000500000019
9100000020000019
9100000030000019
9100000000000019
9100000000000019
9111111111111119
9999999999999999