1111111111111111
1000000000000001
1000000000000001
1000000000000001
1000000000000001
1000000001111001
1000000001001001
1000000001201001
1000000000300001
1000001111110001
1000001500000001
1000000000000001
1000000000000001
1000000000000001
1000000000000001
1111111111111111