9999999999999999
9111111111111119
9100000000000019
9100000000000019
9100000000000019
9100000000000019
9100000000000019
9100000000000019
9100000500000019
9100000000000019
9100000000002019
9100000000003019
9100000000000019
9100000000000019
9111111111111119
9999999999999999