1111111111111111
1000000000000001
1000000000000001
1000101101000001
1000101320000001
1000101301000001
1000100200100001
1000100000100001
1000101111000001
1000052030000001
1000000000000001
1000100000010001
1000011111100001
1000000000000001
1000000000000001
1111111111111111
