999999999999999999
911111111111111119
910000000000000019
910000000000000019
910000000000000019
910000000000000019
910000003000000019
910005002000000019
910000200000000019
910000002300000019
910000300000000019
910000000000000019
910000000000000019
910000000000000019
910000000000000019
910000000000000019
911111111111111119
999999999999999999
