9999999999999999
9111111111111119
9100000000000019
9100101111000019
9100101000000019
9100101311000019
9100100200100019
9100100000100019
9100101111000019
9100000001000019
9100000011000019
9100003200005019
9102011111100019
9103000000000019
9111111111111119
9999999999999999