999999999999999999
911111111111111119
910000000000000019
910000000000000019
910011100000000019
910013100010000019
910010101000000019
910020230010000019
910000100010000019
910001111111000019
910000000100000019
910000001100000019
910000320000000019
910001111110500019
910000000000000019
910000000000000019
911111111111111119
999999999999999999
