11111111111111
10000000000001
10000000000001
10000000000001
10000100010001
10000001000001
10000100010001
10000000000001
10001111111001
10000003100001
10000201100001
10050000000001
10000000000001
11111111111111