11111111111111
10000000000001
10000000000001
10000000000001
10000000000001
10000002300001
10000000000001
10005000000001
10000000000001
10000000000001
10000002300001
10000000000001
10000000000001
11111111111111