1111111111111111
1000000000000001
1000000000000001
1000000003000001
1000111112000001
1000500010000001
1000001000000001
1000021010000001
1000031000000001
1000001000000001
1000001000000001
1000001000000001
1000001000000001
1000001000000001
1000001000000001
1111111111111111