9999999999999999
9111111111111119
9100000000000019
9100000000000019
9100000000000019
9100000000000019
9100000000000019
9100001111110019
9100000050230019
9100001111110019
9100000000000019
9100000000000019
9100000000000019
9100000000000019
9111111111111119
9999999999999999