11111111111111
10000000000001
10000000000001
10000000000001
10000000202301
10000000300001
10000011100001
10001005100001
10000000100001
10001000100001
10000000000001
10000000000001
10000000000001
11111111111111