1111111111111111
1000000000000001
1000000000000001
1000101111000001
1000101000000001
1000101311000001
1000100200100001
1000100000100001
1000101111000001
1000002030000001
1000000000000001
1000103200010001
1000511111100001
1000000000000001
1000000000000001
1111111111111111