1111111111111111
1000000000000001
1000000000000001
1000000000000001
1000000000000001
1000500000230001
1000001210000001
1000021310000001
1000030000000001
1000000000000001
1000000000000001
1000000000000001
1000000000000001
1000000000000001
1000000000000001
1111111111111111