11111111111111
10000000000001
10000000000001
10000000000001
10000102300001
10000500000001
10000102300001
10000000000001
10001111111001
10000000100001
10000001100001
10000000000001
10000000000001
11111111111111