11111111111111
10000000000001
10000000000001
10000100000001
10000000000001
10000100000001
10000000000001
10001111111001
10000203100001
10500231100001
10000000000001
10000000000001
10000000000001
11111111111111