1111111111111111
1000000000000001
1000000000000001
1001032000000001
1001110001000001
1001310100000001
1002000001000001
1000010001000001
1000111111100001
1000000010000001
1000000110000001
1000032050000001
1000111111000001
1000000000000001
1000000000000001
1111111111111111