999999999999999999
911111111111111119
910000000000000019
910000000000100019
910000000000100019
910000000000100019
910111111010100019
910000001010100019
911111101012100019
910000001013100019
910111111011100019
910000001000000019
910005001000000019
910001111000000019
910000000000000019
910000000000000019
911111111111111119
999999999999999999
