1111111111111111
1000100000000001
1500001000000001
1000100000000001
1010000000000001
1000011000000001
1000320000000001
1000000000000001
1000000000000001
1000000000000001
1000000000000001
1000000000000001
1000000000000001
1000000000000001
1000000000000001
1111111111111111