11111111111111
10001000000001
15000010000001
10001000000001
10100000000001
10000110000001
10003200000001
10000000000001
10000000000001
10000000000001
10000000000001
10000000000001
10000000000001
11111111111111