11111111111111
10000000000001
15000000000001
11111111100001
10000032000001
10000000000001
10000000000001
10000000000001
10000000000001
10000000000001
10000000000001
10000000000001
10000000000001
11111111111111