9999999999999999
9111111111111119
9100003000000019
9100000000010019
9100000000010019
9102000000010019
9100000000010019
9101111100110019
9100000000000019
9100000000000019
9111100000000019
9100000000000019
9100000000000019
9150000000000019
9111111111111119
9999999999999999