11111111111111
10000000000001
10000000000001
10000000000001
10000000000001
10000000000001
10000000100001
10000000100001
10000000230001
10000111111101
10000000100001
10000000050001
10000000000001
11111111111111