999999999999999999
911111111111111119
910000000000000019
910000000000000019
910000000000000019
910000000000000019
910000000011111019
910000000010000019
910000000500000019
910001111020000019
910001000030000019
910001111000000019
910000001000000019
910000001000000019
910000000000000019
910000000000000019
911111111111111119
999999999999999999
