999999999999999999
911111111111111119
910000000000000019
910000000000000019
910000020000000019
910000000000000019
910000300500000019
910000000000000019
910000030000000019
910000200000000019
910000000000000019
910000000000000019
910000000000000019
910000000000000019
910000000000000019
910000000000000019
911111111111111119
999999999999999999
