11111111111111
10000000000001
10000000000001
10000000030001
10001111120001
10005000100001
10000010000001
10000210100001
10000310000001
10000010000001
10000010000001
10000010000001
10000010000001
11111111111111