999999999999999999
911111111111111119
910000000000000019
910000000000000019
910000000000000019
910000000000000019
910000000000000019
910000000400000019
910000000000000019
910500000000020019
910000000030000019
910000000000000019
910000000000000019
910000000000000019
910000000000000019
910000000000000019
911111111111111119
999999999999999999
