9999999999999999
9111111111111119
9100000000000019
9100000000000019
9100000000000019
9100000000000019
9100000000000019
9100000000000019
9100000000000019
9100000325000019
9100000000000019
9100000320000019
9100003200000019
9100000000000019
9111111111111119
9999999999999999