999999999999999999
911111111111111119
910000000000000019
910000000000000019
910000000000000019
910000011111100019
910000000000100019
910005002300100019
910000010100100019
910000010203100019
910000010000000019
910000010000000019
910000000000000019
910000000000000019
910000000000000019
910000000000000019
911111111111111119
999999999999999999
