1111111111111111
1000000000000001
1000000000000001
1000100000000001
1000111000100001
1000131010000001
1000200230100001
1000001000100001
1000011111110001
1000000001000001
1000000011000001
1000003200000001
1000011111105001
1000000000000001
1000000000000001
1111111111111111