1111111111111111
1000000000000001
1000000000000001
1001011110000001
1001010000000001
1001013110000001
1001002001000001
1001000001000001
1001011110000001
1000020300000001
1000000000000001
1001032000100001
1000111111000001
1005000000000001
1000000000000001
1111111111111111