999999999999999999
911111111111111119
910000000000000019
910000000000000019
910000000000000019
910000000000000019
910000000000000019
910000111111000019
910000002003000019
910000111111000019
910000000000000019
910000000000000019
910000000000000019
910000000000500019
910000000000000019
910000000000000019
911111111111111119
999999999999999999
